18
25
#########################
#          #  *         #
#                       #
####################   ##   
#   G#   #   #         ##
#                       #
#                       #
#                       #
#                       # 
#                       #
#        #### # ###     #
#         a     #       #
###   D### # # ##  %    #
#     #   #   #         #
#K#######D#  ######     #
#     III               #
#                       #
#########################
