11
20
####################
# %           #    #
# a       $        #
#                  #
#    !         *   #
#####$##### D  #####
# &    $           #
#                  #
#           %      #
#                  #
#################### 
