14
25
########################
#          $        G  #
#                      #
# *                    #
#     #######          #
#                      #
#                      #
#        !     a       #
#                      #
#        I      $      #
#                      #
#                      #
#       T         !    #
########################
